time, x, type
10,50,1
10.5,100,1
11,150,1
11.5,200,1
12,250,1
12.5,300,1
13,350,1
13.5,400,1
14,450,1
14.5,500,1
15,550,1
15.5,600,1
16,650,1
16.5,700,1
17,750,1
17.5,800,1
18,850,1
25,0,5